######################
#...#......##.....#..#
..#.#.####.##.#.#..#.#
###.#....#.##.#.####.#
#....###.#....#......#
####.#.#.#.#########.#
#..#.#.#.#.#...##.####
##.#.#.#.#.#.#.......#
#........#.#.#######.#
######.#.#...#...#.#.#
#......#.#.#...#...#..
#.####..##.#########.#
#.##..#..##......#...#
#....###....###.#..#.#
######################